Ammann	Ammann
Ammann-Verl.	Ammann
Ammann Schweiz AG	Ammann
Aufbau-Verl.	Aufbau
Aufbau-Verlag	Aufbau
Aufbau-Taschenbuch-Verl.	Aufbau
Aufbau-Taschenbuch	Aufbau
Aufbau	Aufbau
Aufbau Taschenbuch	Aufbau
Aufbau-Bühnen-Vertrieb	Aufbau
Aufbau Verl.	Aufbau
Aufbau-Bühnen-Vertrieb G.m.b.H.	Aufbau
Aufbau-Bühnen-Vertrieb GmbH	Aufbau
ATB, Aufbau Taschenbuch	Aufbau
Aufbau-Tachenbuch-Verl.	Aufbau
Aufbau-Verl	Aufbau
Aufbau-Bühnen Vertrieb	Aufbau
Aufbau-Bühnenvertrieb G. m. b. H.	Aufbau
[Aufbau-Bühnen-Vertrieb]	Aufbau
Aufbau-Bühnen-Vertr.	Aufbau
Aufbau-Verl. in Komm.	Aufbau
Aufbau-Bühnenvertrieb G.m.b.H.	Aufbau
Aufbau taschenbuch	Aufbau
Aufbau Verlag	Aufbau
Aufbau-Taschen-Verl.	Aufbau
[Aufbau-Verl. in Komm.]	Aufbau
Aufbau - Verl.	Aufbau
atb Aufbau Taschenbuch	Aufbau
[Aufbau-Verl.]	Aufbau
atb, Aufbau Taschenbuch	Aufbau
Aufbau Taschenbuch-Verl.	Aufbau
Atb, Aufbau Taschenbuch	Aufbau
Aufbau- Verlag	Aufbau
Aufbau-Taschenbuch-Verl.***5108133	Aufbau
Aufbau-Taschenbuchverl.	Aufbau
Aufbau-Taschenbuch-Verlag	Aufbau
Aufbau Verlag GmbH	Aufbau
Berlin-Verl.	Berlin Verlag
Berlin Verlag	Berlin Verlag
Berlin-Verlag	Berlin Verlag
Berlin Verl.	Berlin Verlag
Blumenbar-Verl.	Blumenbar
Blumenbar	Blumenbar
Eichborn	Eichborn
Eichborn-Verl.	Eichborn
[Eichborn]	Eichborn
Eichborn-Verlag	Eichborn
Goldmann	Goldmann
W. Goldmann	Goldmann
Goldmann Verlag	Goldmann
[Goldmann]	Goldmann
Goldmann-Verl.	Goldmann
Wilhelm Goldmann, Verl.	Goldmann
W. Goldmann Verl.	Goldmann
Goldmann Verl.	Goldmann
Hanser	Hanser
Carl Hanser Verlag	Hanser
Hanser Berlin	Hanser
C. Hanser [u.a.]	Hanser
[Hanser]	Hanser
C. Hanser Verl.	Hanser
(Hanser)	Hanser
Hanser **5107516	Hanser
Hanser, Carl	Hanser
Wien : Hanser	Hanser
Heyne	Heyne
Wilhelm Heyne Verlag	Heyne
[Heyne]	Heyne
Wilhem Heyne Verlag	Heyne
Wilhelm Heyne Verlag **5107652	Heyne
Wilhelm  Heyne Verlag	Heyne
Heyne]	Heyne
Wilh. Heyne Verl.	Heyne
Heyne***5107652	Heyne
Wilh. Heyne	Heyne
Hoffmann und Campe	Hoffmann und Campe
Hoffmann u. Campe	Hoffmann und Campe
Hoffmann & Campe	Hoffmann und Campe
Hoffmann & Campe Verl.	Hoffmann und Campe
Hoffman u. Campe	Hoffmann und Campe
Hoffmann und Campe Verlag	Hoffmann und Campe
Hofmann und Campe	Hoffmann und Campe
Hoffman & Campe Verl.	Hoffmann und Campe
Hoffmann ; Campe	Hoffmann und Campe
Frölich u. Kaufmann im Hoffmann-u.-Campe-Verl.	Hoffmann und Campe
Hoffmann un[d] Campe	Hoffmann und Campe
Hoffmann und Campe, Heinrich-Heine-Verl.	Hoffmann und Campe
Hoffmann un Campe	Hoffmann und Campe
Insel-Verl.	Insel
Insel-Verlag	Insel
Insel	Insel
Insel Verlag	Insel
Insel Verl.	Insel
[Insel-Verl.]	Insel
Inselverl.	Insel
Im Insel-Verlag	Insel
Suhrkamp Insel Publ. Boston	Insel
[Insel-Verlag]	Insel
Insel-Verl	Insel
im Insel-Verlag	Insel
Insel-Verl.***5107848	Insel
Insel -Verl.	Insel
Leipzig : Insel-Verl.	Insel
Inselverlag	Insel
Insel.-Verl.	Insel
Insel- Verl.	Insel
Insel-Verl. in Komm.	Insel
Insel. Verlag	Insel
Insel-Verlag]	Insel
Insel[-Verlag]	Insel
Insel-Verlag.	Insel
Insel.Verl.	Insel
Verlags-Insel	Insel
[Insel Verl.]	Insel
S. Insel	Insel
Insel-Verlag in Komm.]	Insel
Suhrkamp/Insel	Insel
Kiepenheuer und Witsch	Kiepenheuer & Witsch
Kiepenheuer & Witsch	Kiepenheuer & Witsch
Kiepenheuer u. Witsch	Kiepenheuer & Witsch
Verlag Kiepenheuer & Witsch	Kiepenheuer & Witsch
Kiepenheuer und Witsch [in Komm.]	Kiepenheuer & Witsch
Theaterverl. Kiepenheuer u. Witsch	Kiepenheuer & Witsch
[Kiepenheuer & Witsch in Komm.]	Kiepenheuer & Witsch
[Kiepenheuer & Witsch]	Kiepenheuer & Witsch
Kiepeneheuer & Witsch	Kiepenheuer & Witsch
Kiepenheuer [& Witsch]	Kiepenheuer & Witsch
Kiepenheuer u. Witsch [in Komm.]	Kiepenheuer & Witsch
Kiepenheuer und& Witsch	Kiepenheuer & Witsch
Kiepenheuer, Witsch & Co	Kiepenheuer & Witsch
Verlag Kiepenheuer & Witsch Bühnenvertrieb	Kiepenheuer & Witsch
Verlag Kiepenheuer u. Witsch	Kiepenheuer & Witsch
Luchterhand	Luchterhand Literaturverlag
Luchterhand-Literaturverl.	Luchterhand Literaturverlag
Luchterhand-Literatur-Verl.	Luchterhand Literaturverlag
[Luchterhand-Literaturverl.]	Luchterhand Literaturverlag
Luchterhand Literaturverl.	Luchterhand Literaturverlag
Luchterhand Literaturverlag	Luchterhand Literaturverlag
Luchterhand, Literaturverl.	Luchterhand Literaturverlag
Luchterhand-Verl.	Luchterhand Literaturverlag
Manesse-Verl.	Manesse
Manesse-Verlag	Manesse
Manesse Verl.	Manesse
Manesse	Manesse
Manesse Verlag	Manesse
Manesse Verl. Conzett & Huber	Manesse
Manesse-Verl. Conzett & Huber	Manesse
Merve-Verl.	Merve
Merve-Verlag	Merve
Merve	Merve
Merve Verlag	Merve
Merve -Verl.***90117	Merve
Nagel und Kimche	Nagel & Kimche
Nagel & Kimche	Nagel & Kimche
Nagel u. Kimche	Nagel & Kimche
; Frauenfeld : Nagel und Kimche	Nagel & Kimche
Piper	Piper
R. Piper & Co.	Piper
[Piper]	Piper
Piper & Co.	Piper
R. Piper	Piper
Kabel by Piper	Piper
Zürich : Piper	Piper
R. Piper & Co Verlag	Piper
Verl. d. Marées-Gesellschaft R. Piper & Co.	Piper
Piper ; Zürich	Piper
R. Piper & Co	Piper
Piper [in Komm.]	Piper
R. Piper & Co. G. m. b. H.	Piper
Verl. d. Marées-Gesellschaft Piper	Piper
Rogner und Bernhard	Rogner & Bernhard
Rogner und Bernhard bei Zweitausendeins	Rogner & Bernhard
Rogner u. Bernhard	Rogner & Bernhard
Rogner & Bernhard	Rogner & Bernhard
Rogner & Bernhard bei Zweitausendeins	Rogner & Bernhard
Rogner u. Bernhard bei Zweitausendeins	Rogner & Bernhard
Rogner and Bernhard bei Zweitausendeins	Rogner & Bernhard
Rogner und Bernard	Rogner & Bernhard
Rowohlt	Rowohlt
Rowohlt-Taschenbuch-Verl.	Rowohlt
Rowohlt Berlin	Rowohlt
E. Rowohlt	Rowohlt
Rowohlt-Taschenbuch-Verlag	Rowohlt
Rowohlt Taschenbuch Verlag	Rowohlt
Rowohlt Polaris	Rowohlt
Rowohlt-Theater-Verlag	Rowohlt
Rowohlt G. m. b. H.	Rowohlt
Rowohlt[-Taschenbuch-Verl.]	Rowohlt
Rowohlt-Taschenbuchverl.	Rowohlt
Rowohlt G.m.b.H.	Rowohlt
Ernst Rowohlt	Rowohlt
Rowohlt, Theater-Verlag	Rowohlt
[E. Rowohlt]	Rowohlt
Rowohlt-Taschenbuch-Verl.***5108801	Rowohlt
Rowohlt-Taschenbuch Verl.	Rowohlt
Rowohlt-Verl.	Rowohlt
Rowohlt Verl.	Rowohlt
Rowohlt-Taschenbuch-Verl	Rowohlt
[Rowohlt-Taschenbuch-Verl.]	Rowohlt
Rowohlt Verlag	Rowohlt
Rowohlt-Taschenbuch-verl.	Rowohlt
Rowohlt Taschenbuch	Rowohlt
Rowohlt Berlin***5106439	Rowohlt
Ernst Rowohlt Verl.	Rowohlt
Rowohlt- Taschenbuch-Verlag	Rowohlt
Rowohlt Taschenbuch-Verl.	Rowohlt
Rowohlt [Verl. G.m.b.H.]	Rowohlt
Rowohlt Verl. G. m. b. H.	Rowohlt
RowohltTtaschenbuch-Verl.	Rowohlt
Rowohlt-Taschenbuch--Verl.	Rowohlt
Rowohlts	Rowohlt
Rowohlt V.	Rowohlt
E. Rowohlt Verl.	Rowohlt
Rowohlt Hundert Augen	Rowohlt
Ernst Rowohlt Verlag	Rowohlt
Rowohlt-Taschnebuch-Verl.	Rowohlt
[J. Rowohlt]	Rowohlt
Rowohlt-Taschenbuch-Verl. **5108801	Rowohlt
Rowohlt-Taschenbuch -Verl.	Rowohlt
Rowohlt-Taschenbuch -Verl.***5108801	Rowohlt
Rowohlt-Taschenbuchverlag	Rowohlt
[Rowohlt]	Rowohlt
Rowohlt-Taschenbuch.Verl.	Rowohlt
Rowohlt-Taschenbuch-Ausg.	Rowohlt
Rowohlt-Tashenbuch-Verl.	Rowohlt
Rowohlt-[Taschenbuch-Verl.]	Rowohlt
Rowohlt [G. m. b. H.]	Rowohlt
Schöffling	Schöffling & Co.
Schöffling & Co.	Schöffling & Co.
[Schöffling]	Schöffling & Co.
Suhrkamp	Suhrkamp
Suhrkamp Verlag	Suhrkamp
Suhrkamp-Taschenbuch-Verlag [in Komm.]	Suhrkamp
Suhrkamp-Theaterverlag	Suhrkamp
Jüdischer Verl. im Suhrkamp-Verl.	Suhrkamp
Suhrkamp-Verl.	Suhrkamp
Suhrkamp [in Komm.]	Suhrkamp
S. Fischer Verl. [Suhrkamp]	Suhrkamp
Suhrkamp-Taschenbuch-Verlag	Suhrkamp
Suhrkamp Insel Publ. Boston	Suhrkamp
Suhrkamp-Theaterverl.	Suhrkamp
[Suhrkamp]	Suhrkamp
Suhrkamp Verl.	Suhrkamp
Jüdischer Verlag im Suhrkamp Verlag	Suhrkamp
Suhrkamp-Taschenbuchverlag [in Komm.]	Suhrkamp
Suhrkamp vorm. S. Fischer	Suhrkamp
Suhrkamp-Taschenbuch-Verl.	Suhrkamp
Suhrkamp Publ.	Suhrkamp
Suhrkamp Publ. New York	Suhrkamp
Suhrkamp-Taschenbuch- Verlag [in Komm.]	Suhrkamp
Suhrkamp, Theaterverlag	Suhrkamp
Suhrkamp-Theater-Verl.	Suhrkamp
Suhrkamp Theaterverl.	Suhrkamp
Suhrkamp-Verl. vorm. S. Fischer	Suhrkamp
Suhrkamp, Theaterverl.	Suhrkamp
Suhrkamp-Taschenbuch-Velag [in Komm.]	Suhrkamp
Suhrkamp-Verlag	Suhrkamp
Suhrkamp55	Suhrkamp
S. Fischer [Suhrkamp-Verl.]	Suhrkamp
Suhrkamp/Insel	Suhrkamp
S. Fischer Verl. [Suhrkamp.]	Suhrkamp
Jüdischer Verl. im Suhrkamp-Verl.***98602	Suhrkamp
Ullstein	Ullstein
Ullstein-Taschenbuchverl.	Ullstein
Ullstein Taschenbücher-Verl.	Ullstein
Moewig bei Ullstein	Ullstein
Ullstein A. G.	Ullstein
Ullstein [A. G.]	Ullstein
Ullstein A.G.	Ullstein
Ullstein A.-G.	Ullstein
Ullstein [A.G.]	Ullstein
Ullstein-Verl.	Ullstein
Ullstein-Taschenbuch-Verl.	Ullstein
Ullstein-Taschenbücher-Verl.	Ullstein
Ullstein Taschenbücher Verl.	Ullstein
Ullstein [& Co.]	Ullstein
Ullstein [A.-G.]	Ullstein
Econ-Ullstein-List-Verl.	Ullstein
Ullstein & Co.	Ullstein
Ullstein Extra	Ullstein
Ullstein AG	Ullstein
Safari bei Ullstein	Ullstein
[Ullstein & Co.]	Ullstein
Ullstein Taschenbuch Verlag	Ullstein
Fridolin-Verlag Ullstein A.-G.	Ullstein
Ullstein [Deutscher Verl.]	Ullstein
Verlag Ullstein	Ullstein
Ullstein]	Ullstein
Ullstein Taschenbuchverl.	Ullstein
Ullstein extra	Ullstein
[Ullstein]	Ullstein
Propyläen-Verl. Ullstein	Ullstein
Verlag Ullstein GmbH	Ullstein
Ullstein Taschenbuch-Verl.	Ullstein
Ullstein Mosby	Ullstein
Ullstein & Kindler	Ullstein
Berliner Morgenpost, Ullsteinhaus	Ullstein
Ullstein/Kindler	Ullstein
Ullsteinhaus	Ullstein
Bauwelt-Verlag Ullstein [A. G.]	Ullstein
Ullstein-Kindler	Ullstein
Verlag der Ullstein-Schnittmuster	Ullstein
Deutscher Verl. d. Ullstein A.G.	Ullstein
[Ullstein A.G.]	Ullstein
Slowo [Verlagsgesellschaft, durch Ullstein & Co.]	Ullstein
Slowo-Verlagsgesellschaft [durch Ullstein & Co]	Ullstein
Bauwelt-Verl. [Ullstein]	Ullstein
Ullstein [Taschenbücher Verl.]	Ullstein
Ullstein-Taschenbuch	Ullstein
Ullsteine	Ullstein
Ullstein Verl.	Ullstein
Rot-Blau Verl. Ullstein	Ullstein
Rot-Blau-Verl. [Ullstein]	Ullstein
Ullstein Bücher	Ullstein
Ullstein, Kindler	Ullstein
Ullstein-Taschenbücher-Verlag	Ullstein
Ullstein **5109136	Ullstein
Ullstein Taschenbücher- Verl.	Ullstein
Verl. Ullstein	Ullstein
Slowo Verlagsgesellschaft [durch Ullstein & Co.]	Ullstein
Ullstein Taschen-bücher Verl.	Ullstein
Ullstein Taschenbücherverl.	Ullstein
Verl. d. Grünen Post Ullstein	Ullstein
Engeler	Urs Engeler Editor
[Engeler]	Urs Engeler Editor
Engeler-Verlag	Urs Engeler Editor
U. Engeler	Urs Engeler Editor
[Urs Engeler]	Urs Engeler Editor
Verbrecher-Verl.	Verbrecher Verlag
Verbrecher Verlag	Verbrecher Verlag
Verbrecher	Verbrecher Verlag
Verbrecher Verl.	Verbrecher Verlag
Voland & Quist	Voland & Quist
Voland	Voland & Quist
Verlag Voland & Quist	Voland & Quist
Voland und Quist	Voland & Quist
Verlag Voland & Quist GmbH	Voland & Quist
Wallstein-Verl.	Wallstein
Wallstein Verlag	Wallstein
Wallstein	Wallstein
D A Wallstein	Wallstein
Wallstein Verl.	Wallstein
[Wallstein-Verl.]	Wallstein
Wiesenburg-Verl.	Wiesenburg
Wiesenburg	Wiesenburg
Wiesenburg Verlag	Wiesenburg
